Your homework is due. Finish your assignment or else you will drop of out Cal Poly!

Gotta Graduate
An Interactive Fiction by Robin Verweij, David O'Connor, Ryan Chan, Luke Plewa, Lauren Thurston, and Russell Taylor
Release 1 / Serial number 130422 / Inform 7 build 6G60 (I6/v6.32 lib 6/12N) SD

Software Design Lab
A lab room lined with computers with a projector and table at the center. North is a doorway leading to the hall.

You can see Software Design Lab Door, a charger, keylogger and Dr Gene Fisher here.

>l
Software Design Lab
A lab room lined with computers with a projector and table at the center. North is a doorway leading to the hall.

You can see Door1 here.

>open door1
You open Door1.

>n
Hallway 1
To the west there is a staircase, but you have no need to go downstairs. To the north is a door leading outside. Continue East down the Hallway

You can see Door1 here.

>n
You can't go that way.

>s
Software Design Lab
A lab room lined with computers with a projector and table at the center. North is a doorway leading to the hall.

You can see Door1 here.

* * *

>l
Software Design Lab
A lab room lined with computers with a projector and table at the center. North is a doorway leading to the hall.

You can see Door1 here.

>n
You can't go that way.

>n
You can't go that way.

>s
You can't go that way.

>w
You can't go that way.

>e
You can't go that way.

* * *

>l
Software Design Lab
A lab room lined with computers with a projector and table at the center. North is a doorway leading to the hall.

You can see Door1 here.

>open door 1
You can't see any such thing.

>l
Software Design Lab
A lab room lined with computers with a projector and table at the center. North is a doorway leading to the hall.

You can see Door1 here.

>open Door1
You open Door1.

>x Door1
You see nothing special about Door1.

* * *

>l
Software Design Lab
A lab room lined with computers with a projector and table at the center. North is a doorway leading to the hall.

You can see Door1 here.

>open Sofware Design Lab Door
You can't see any such thing.

* * *

>l
Software Design Lab
A lab room lined with computers with a projector and table at the center. North is a doorway leading to the hall.

You can see Door1 here.

>l
Software Design Lab
A lab room lined with computers with a projector and table at the center. North is a doorway leading to the hall.

You can see Door1 here.

* * *

Your homework is due. Finish your assignment or else you will drop of out Cal Poly!

Gotta Graduate
An Interactive Fiction by Robin Verweij, David O'Connor, Ryan Chan, Luke Plewa, Lauren Thurston, and Russell Taylor
Release 1 / Serial number 130422 / Inform 7 build 6G60 (I6/v6.32 lib 6/12N) SD

Software Design Lab
A lab room lined with computers with a projector and table at the center. North is a doorway leading to the hall.

You can see Software Design Lab Door, a charger, keylogger and Dr Gene Fisher here.

>n
(first opening Door1)

Hallway 1
To the west there is a staircase, but you have no need to go downstairs. To the north is a door leading outside. Continue East down the Hallway

You can see Door1 here.

>w
You can't go that way.

>e
Hallway 2
Continue East down the Hallway or south into the Game Design Lab

You can see Door2 here.

>e
Hallway 3
Continue East down the Hallway

>e
Hallway 4
Continue North to the South Faculty Offices or east down the hallway.

>e
Hallway 5
Continue east down the hallway.

>e
Hallway 6
Continue east down the hallway.

>e
Hallway 7
To the south is room 250. You can go east or west in the East Hall.

You can see Door 252 and Door 246 here.

>e
Hallway 8
To the north is room 249. To the south is room 250. You can go east or west down the East Hall.

You can see Door 251 and Door 248 here.

>e
Hallway 9
To the east is a staircase. To the south is a door leading out. To the north is Room 249 and to the south is Room 250. You can go west in the East Hall.

You can see Door 250 and Door 249 here.

>e
You can't go that way.

>w
Hallway 8
To the north is room 249. To the south is room 250. You can go east or west down the East Hall.

You can see Door 251 and Door 248 here.

>w
Hallway 7
To the south is room 250. You can go east or west in the East Hall.

You can see Door 252 and Door 246 here.

>w
Hallway 6
Continue east down the hallway.

>w
Hallway 5
Continue east down the hallway.

>w
Hallway 4
Continue North to the South Faculty Offices or east down the hallway.

>n
SouthEast Corridor
You're in the Southern end of the East Outdoor Corridor. To the north is a fallen vending machine that is blocking your path. The archways to the east have been fenced off. Your only option is to head west toward the the South Faculty Offices.

>e
You can't go that way.

>w
South Faculty Atrium
You're in the center of the southern faculty offices. To the north and south are enterances to the faculty offices.

>w
SouthWest Corridor
You're in the Northern end of the West Outdoor Corridor. The west is fenced off, but the corridor continues to the North. To the south is a locked door and to the west are the South Faculty Offices.

>n
NorthWest Corridor
You're in the West Corridor. The west is still fenced off. To the north is another fallen vending machine. Weird... Seems your only option is to head east toward the North Faculty Offices

>e
North Faculty Atrium
You're in the center of the northern faculty offices. To the north and south are enterances to the faculty offices.

>e
NorthEast Corridor
You're in the Northern end of the Eastern Corridor. To the south is the first fallen vending machine you saw. The eastern archways are still fenced off. You can see that to the north the path is clear.

>n
(first opening csl-239-D)

csl-239

>n
You can't go that way.

>s
NorthEast Corridor
You're in the Northern end of the Eastern Corridor. To the south is the first fallen vending machine you saw. The eastern archways are still fenced off. You can see that to the north the path is clear.

>n
csl-239

>e
You can't go that way.

>w
You can't go that way.

* * *

>n
(first opening Door1)

Hallway 1
To the west there is a staircase, but you have no need to go downstairs. To the north is a door leading outside. Continue East down the Hallway

You can see Door1 here.

>n
You can't go that way.

>e
Hallway 2
Continue East down the Hallway or south into the Game Design Lab

You can see Door2 here.

* * *

>e
Hallway 3
Continue East down the Hallway

>e
Hallway 4
Continue North to the South Faculty Offices

* * *

>n
You can't go that way.

>open door
You can't see any such thing.

>x door
You can't see any such thing.

* * *

>n
(first opening Door1)

Hallway 1
To the west there is a staircase, but you have no need to go downstairs. To the north is a door leading outside. Continue East down the Hallway

You can see Door1 here.

>e
Hallway 2
Continue East down the Hallway or south into the Game Design Lab

You can see Door2 here.

* * *

>e
Hallway 5
Continue east down the hallway.

>n
You can't go that way.

>w
South Faculty Atrium
You're in the center of the southern faculty offices. To the north and south are enterances to the faculty offices.

>n
Faculty Entrances1
You see seven faculty offices:  14-205, 14-206, 14-207, 14-208, 14-209, 14-210, 14-211. You can enter each office and look around.

>enter 14-205
You get into the 14-205.

>exit
You get out of the 14-205.

Faculty Entrances1
You see seven faculty offices:  14-205, 14-206, 14-207, 14-208, 14-209, 14-210, 14-211. You can enter each office and look around.

* * *

>e
Hallway 7
To the south is room 250. You can go east or west in the East Hall.

You can see Door 252 and Door 246 here.

>e
Hallway 8
To the north is room 249. To the south is room 250. You can go east or west down the East Hall.

You can see 249-Door here.

>e
Hallway 9
To the east is a staircase. To the south is a door leading out. To the north is Room 249. You can go west in the East Hall.

>e
You can't go that way.

>e
You can't go that way.

* * *

>e
Hallway 7
To the south is room 250. You can go east or west in the East Hall.

You can see Door 252 and Door 246 here.

>s
(first opening Door 252)

Room 252
There is a door to the north.

You can see Door 252 here.

>n
Hallway 7
To the south is room 250. You can go east or west in the East Hall.

You can see Door 252 and Door 246 here.

>n
(first opening Door 246)

Room 246
There is a door to the south.

You can see Door 246 here.

>s
Hallway 7
To the south is room 250. You can go east or west in the East Hall.

You can see Door 246 and Door 252 here.

>e
Hallway 8
To the north is room 249. To the south is room 250. You can go east or west down the East Hall.

You can see Door 251 and Door 248 here.

>n
(first opening Door 248)

Room 248
There is a door to the south.

You can see Door 248 here.

>s
Hallway 8
To the north is room 249. To the south is room 250. You can go east or west down the East Hall.

You can see Door 248 and Door 251 here.

>s
(first opening Door 251)

Room 251
There is a door to the north.

You can see Door 251 here.

>n
Hallway 8
To the north is room 249. To the south is room 250. You can go east or west down the East Hall.

You can see Door 251 and Door 248 here.

>e
Hallway 9
To the east is a staircase. To the south is a door leading out. To the north is Room 249. You can go west in the East Hall.

You can see Door 250 and Door 249 here.

>s
(first opening Door 250)

Room 250
There is a door to the north. You can move west.

You can see Door 250 here.

>n
Hallway 9
To the east is a staircase. To the south is a door leading out. To the north is Room 249. You can go west in the East Hall.

You can see Door 250 and Door 249 here.

>n
(first opening Door 249)

Room 249
There is a door to the south. You can move west.

You can see Door 249 here.

>s
Hallway 9
To the east is a staircase. To the south is a door leading out. To the north is Room 249. You can go west in the East Hall.

You can see Door 249 and Door 250 here.

* * *

>e
Hallway 7
To the south is room 250. You can go east or west in the East Hall.

You can see Door 252 and Door 246 here.

>open door
You can't see any such thing.

>open door 251
You can't see any such thing.

* * *

>e
Hallway 4
Continue North to the South Faculty Offices or east down the hallway.

>n
SouthEast Corridor
You're in the Southern end of the East Outdoor Corridor. To the north is a fallen vending machine that is blocking your path. The archways to the east have been fenced off. Your only option is to head west toward the the South Faculty Offices.

>w
South Faculty Atrium
You're in the center of the southern faculty offices. To the north and south are enterances to the faculty offices.

* * *

>w
SouthWest Corridor
You're in the Northern end of the West Outdoor Corridor. The west is fenced off, but the corridor continues to the North. To the south is a locked door and to the west are the South Faculty Offices.

>w
You can't go that way.

>n
NorthWest Corridor
You're in the West Corridor. The west is still fenced off. To the north is another fallen vending machine. Weird... Seems your only option is to head east toward the North Faculty Offices

* * *

>e
North Faculty Atrium
You're in the center of the northern faculty offices. To the north and south are enterances to the faculty offices.

>n
Faculty Entrances3
You see five faculty offices:  14-219, 14-221, 14-222, 14-223, 14-226. You can enter each office and look around.

>s
North Faculty Atrium
You're in the center of the northern faculty offices. To the north and south are enterances to the faculty offices.

>s
Faculty Entrances4
You see seven faculty offices:  14-217, 14-218, 14-227, 14-228, 14-229, 14-230, 14-231. You can enter each office and look around.

>n
North Faculty Atrium
You're in the center of the northern faculty offices. To the north and south are enterances to the faculty offices.

>w
NorthWest Corridor
You're in the West Corridor. The west is still fenced off. To the north is another fallen vending machine. Weird... Seems your only option is to head east toward the North Faculty Offices

>e
North Faculty Atrium
You're in the center of the northern faculty offices. To the north and south are enterances to the faculty offices.

* * *

>e
Hallway 2
Continue East down the Hallway or south into the Game Design Lab

You can see Door2 here.

>w
Hallway 1
To the west there is a staircase, but you have no need to go downstairs. To the north is a door leading outside. Continue East down the Hallway

* * *

Your homework is due. Finish your assignment or else you will drop of out Cal Poly!

Gotta Graduate
An Interactive Fiction by Robin Verweij, David O'Connor, Ryan Chan, Luke Plewa, Lauren Thurston, and Russell Taylor
Release 1 / Serial number 130422 / Inform 7 build 6G60 (I6/v6.32 lib 6/12N) SD

Software Design Lab
A lab room lined with computers with a projector and table at the center. North is a doorway leading to the hall.

You can see Software Design Lab Door, a charger, keylogger and Dr Gene Fisher here.

>s
You can't go that way.

>n
(first opening Software Design Lab Door)

Hallway 1
To the west there is a staircase, but you have no need to go downstairs. To the north is a door leading outside. Continue East down the Hallway

You can see Software Design Lab Door here.

>l
Hallway 1
To the west there is a staircase, but you have no need to go downstairs. To the north is a door leading outside. Continue East down the Hallway

You can see Software Design Lab Door here.

>open door
You can't see any such thing.

>enter door
You can't see any such thing.

>n
You can't go that way.

>s
Software Design Lab
A lab room lined with computers with a projector and table at the center. North is a doorway leading to the hall.

You can see Software Design Lab Door, a charger, keylogger and Dr Gene Fisher here.

>talk to gene
Dr. Fisher declares, "There seems to be something with the servers.

I'm going to leave and look for help. You can do the same if you wish, but don't leave without taking your phone charger. I have heard of phone applications that professors have made to help debug the servers. One of those professors may be on campus right now. If your phone isn't charged, you won't be able to use these applications."

Dr. Fisher leaves the room.

>take charger
Taken.

>s
You can't go that way.

>n
Hallway 1
To the west there is a staircase, but you have no need to go downstairs. To the north is a door leading outside. Continue East down the Hallway

You can see Software Design Lab Door here.

>e
Hallway 2
Continue east down the Hallway or south into the Game Design Lab

You can see Game Design Lab Door here.

>s
(first opening Game Design Lab Door)
It seems to be locked.

>e
Hallway 3
Continue East down the Hallway or north into the Janitor's Closet.

You can see Janitor's Closet Door here.

>s
You can't go that way.

>n
(first opening Janitor's Closet Door)

Janitor's Closet
Perhaps there is something useful in here.

You can see Janitor's Closet Door and a key here.

>e
You can't go that way.

>n
You can't go that way.

>s
Hallway 3
Continue East down the Hallway or north into the Janitor's Closet.

You can see Janitor's Closet Door here.

>n
Janitor's Closet
Perhaps there is something useful in here.

You can see Janitor's Closet Door and a key here.

>take key
Taken.

>s
Hallway 3
Continue East down the Hallway or north into the Janitor's Closet.

You can see Janitor's Closet Door here.

>e
Hallway 4
Continue North to the South Faculty Offices or east down the hallway.

>w
Hallway 3
Continue East down the Hallway or north into the Janitor's Closet.

You can see Janitor's Closet Door here.

>w
Hallway 2
Continue east down the Hallway or south into the Game Design Lab

You can see Game Design Lab Door here.

>s
(first opening Game Design Lab Door)
It seems to be locked.

>talk to zoe
You can't see any such thing.

>download ddos
You can't see any such thing.

>i
You are carrying:
  a key
  a charger
  a phone

>launch ddos
You can't see any such thing.

>l
Hallway 2
Continue east down the Hallway or south into the Game Design Lab

You can see Game Design Lab Door here.

>unlock door with key
You can't see any such thing.

>i
You are carrying:
  a key
  a charger
  a phone

>unlock game design lab door with key
You can't see any such thing.

>unlock
What do you want to unlock?

>l
Hallway 2
Continue east down the Hallway or south into the Game Design Lab

You can see Game Design Lab Door here.

>unlock door
You can't see any such thing.

>unlock door3
You can't see any such thing.

>unlock Door3
You can't see any such thing.